1111111111111
10010000000C1
1100011111001
1P0011E000001
1100000000001
1111111111111
