1111111111111
1000100X00001
1P00C00000E11
1111111111111
