111111
1000P1
1C10E1
1100X1
111111
