111111111111111111111111111111
1E0X00000000000C00000C00000001
101001010010000010100100010101
101001001010101000100100010101
1P0000000C00C000000000000000C1
111111111111111111111111111111
